TILEMAP
32 20                               -- Size of tile map in tiles
20 20                               -- Tile size & block size
images/GOOD.png  	    -- Tilesheet
12 8                                -- Number of tiles in tilesheet
83-83-83-83-83-83-83-83-83-83-83-83-83-83-83-83-83-83-83-83-83-83-83-83-83-83-83-83-83-83-83-83
83-83-83-83-83-83-83-83-83-83-83-83-83-83-83-83-83-83-83-83-83-83-83-83-83-83-83-83-83-83-83-83
83-83-83-83-83-83-83-83-83-83-83-83-83-83-83-83-83-83-83-83-83-83-83-83-83-83-83-83-83-83-83-83
83-83-83-83-83-83-83-83-83-83-83-83-83-83-83-83-83-83-83-83-83-83-83-83-83-83-83-83-83-83-83-83
83-83-83-83-83-83-83-83-83-83-83-83-83-83-83-83-83-83-83-83-83-83-83-83-83-83-83-83-83-83-83-83
83-83-83-83-83-83-83-83-83-83-83-83-83-83-9-10-11-12-83-83-83-83-83-83-83-83-83-83-83-83-83-83
83-83-83-83-83-83-83-83-83-83-83-83-83-83-21-22-23-24-83-83-83-83-83-83-83-83-83-83-83-83-83-83
83-83-83-83-83-83-83-83-83-83-83-83-83-83-33-34-35-36-83-83-83-83-83-83-83-83-83-83-83-83-83-83
83-83-83-83-83-83-83-83-83-83-83-83-83-83-45-46-47-48-83-83-83-83-83-83-83-83-83-83-83-83-83-83
83-83-5-6-7-8-5-6-7-8-5-6-7-8-5-6-7-8-5-6-7-8-5-6-7-8-1-2-3-4-83-83
83-83-17-18-19-20-17-18-19-20-17-18-19-20-17-18-19-20-17-18-19-20-17-18-19-20-13-14-15-16-83-83
83-83-29-30-31-32-29-30-31-32-29-30-31-32-29-30-31-32-29-30-31-32-29-30-31-32-25-26-27-28-83-83
83-83-41-42-43-44-41-42-43-44-41-42-43-44-41-42-43-44-41-42-43-44-41-42-43-44-37-38-39-40-83-83
50-50-50-50-50-50-50-50-50-50-50-50-50-50-50-50-50-50-50-50-50-50-50-50-50-50-50-50-50-50-50-50
61-61-61-61-61-61-61-61-61-61-61-61-61-61-61-61-61-61-61-61-61-61-61-61-61-61-61-61-61-61-61-61
61-61-61-61-61-61-61-61-61-61-61-61-61-61-61-61-61-61-61-61-61-61-61-61-61-61-61-61-61-61-61-61
61-61-61-61-61-61-61-61-61-61-61-61-61-61-61-61-61-61-61-61-61-61-61-61-61-61-61-61-61-61-61-61
61-61-61-61-61-61-61-61-61-61-61-61-61-61-61-61-61-61-61-61-61-61-61-61-61-61-61-61-61-61-61-61
61-61-61-61-61-61-61-61-61-61-61-61-61-61-61-61-61-61-61-61-61-61-61-61-61-61-61-61-61-61-61-61
61-61-61-61-61-61-61-61-61-61-61-61-61-61-61-61-61-61-61-61-61-61-61-61-61-61-61-61-61-61-61-61
