TILEMAP
32 24                             -- Size of tile map in tiles
20 20                             -- Tile size & block size
images/goonies_intro.png          -- Tilesheet
30 8                              -- Number of tiles in tilesheet
55-55-55-55-55-55-55-55-55-55-55-55-55-55-55-55-55-55-55-55-55-55-55-55-55-55-55-55-55-55-55-55
55-55-55-55-55-55-55-55-55-55-55-55-55-55-55-55-55-55-55-55-55-55-55-55-55-55-55-55-55-55-55-55
55-55-55-55-55-55-55-55-55-55-55-55-55-55-55-55-55-55-55-55-55-55-55-55-55-55-55-55-55-55-55-55
55-55-55-55-55-55-55-55-55-55-55-55-55-55-55-55-55-55-55-55-55-55-55-55-55-55-55-55-55-55-55-55
55-55-55-55-55-55-55-55-55-55-55-55-55-55-55-55-55-55-55-55-55-55-55-55-55-55-55-55-55-55-55-55
55-55-55-55-55-55-55-55-55-55-55-55-55-55-55-55-55-55-55-55-55-55-55-55-55-55-55-55-55-55-55-55
55-55-55-55-55-55-55-55-55-2-3-4-5-6-7-8-9-10-11-12-13-14-15-55-55-55-55-55-55-55-55-55
55-55-55-55-55-55-55-55-31-32-33-34-35-36-37-38-39-40-41-42-43-44-45-55-55-55-55-55-55-55-55-55
55-55-55-55-55-55-55-55-61-62-63-64-65-66-67-68-69-70-71-72-73-74-75-55-55-55-55-55-55-55-55-55
55-55-55-55-55-55-55-55-91-92-93-94-95-96-97-98-99-100-101-102-103-104-105-55-55-55-55-55-55-55-55-55
55-55-55-55-55-55-55-55-121-122-123-124-125-126-127-128-129-130-131-132-133-134-211-212-55-55-55-55-55-55-55-55
55-55-55-55-55-55-55-55-55-55-55-55-55-55-55-55-55-55-55-55-55-55-55-55-55-55-55-55-55-55-55-55
55-55-55-55-55-55-55-55-55-55-161-192-196-195-182-194-190-55-152-160-159-157-55-55-55-55-55-55-55-55-55-55
55-55-55-55-55-55-55-55-55-55-55-55-55-55-55-55-55-55-55-55-55-55-55-55-55-55-55-55-55-55-55-55
55-55-55-55-55-55-55-55-55-55-55-55-55-55-55-55-55-55-55-55-55-55-55-55-55-55-55-55-55-55-55-55
55-55-55-55-55-55-55-55-55-55-55-55-55-55-55-55-55-55-55-55-55-55-55-55-55-55-55-55-55-55-55-55
6-16-16-16-16-16-197-199-186-200-200-16-16-16-16-16-16-16-16-16-16-16-16-16-16-16-16-16-16-16-16-16
16-16-16-16-16-16-16-16-16-16-16-16-16-16-16-16-16-16-16-16-16-16-16-16-16-16-16-16-16-16-16-16
16-16-16-16-16-16-200-197-182-184-186-16-181-16-197-193-182-206-16-16-16-16-16-16-16-16-16-16-16-16-16-16
16-16-16-16-16-16-16-16-16-16-16-16-16-16-16-16-16-16-16-16-16-16-16-16-16-16-16-16-16-16-16-16
16-16-16-16-16-16-16-16-207-16-16-16-181-16-190-195-200-201-199-202-184-201-190-196-195-200-16-16-16-16-16-16
16-16-16-16-16-16-16-16-16-16-16-16-16-16-16-16-16-16-16-16-16-16-16-16-16-16-16-16-16-16-16-16
55-55-55-55-55-55-55-55-55-55-55-55-55-55-55-55-55-55-55-55-55-55-55-55-55-55-55-55-55-55-55-55
55-55-55-55-55-55-55-55-55-55-55-55-55-55-55-55-55-55-55-55-55-55-55-55-55-55-55-55-55-55-55-55
